NO ./sprites/cash.xpm
SO ./sprites/player.xpm

F 0,0,0


  EA ./sprites/cafe.xpm
  WE ./sprites/wall.xpm

C 0,150,255

11111111111111111111111111111
    1000000000110000010000001
    1000000000110000010000001
    10110000011100N0000N00001
    1001000000000000000000001
    1111111111111111111111111